1111111111
1P00000E01
1000000011
100C0000C1
1111111111
