1111111111
1P00000001
1000000001
100C0000E1
1111111111
