11111111111111111111
1000P0001C00000000C1
10000000111110111111
10000000000000000001
10000000100000000001
10000000100000000001
11100011100000000001
10000000100000000001
1E0000001000000000C1
11111111111111111111
