1111111111
1P000000C1
1000000001
10000000E1
2111111111
