1111111111111111111111111111111111111111
111111111111111111C111111111111111111111
1111111111111111110111111111111111111111
1111111111111111110111111111111111111111
1111111111111111110111111111111111111111
1111111111111111110111111111111111111111
1111111111111111110111111111111111111111
1111111111111111110111111111111111111111
1111111111111111110111111111111111111111
1E000000000000000000000000000000000000P1
1111111111111111110111111111111111111111
1111111111111111110111111111111111111111
1111111111111111110111111111111111111111
1111111111111111110111111111111111111111
1111111111111111110111111111111111111111
1111111111111111110111111111111111111111
1111111111111111110111111111111111111111
1111111111111111110111111111111111111111
1111111111111111110111111111111111111111
111111111111111111C111111111111111111111
1111111111111111111111111111111111111111
